###########
#@        #
#         #
#         #
#   *.    #
#  **$    #
#         #
#         #
###########