 ######
#  @   #
#       #
#    .       #
#     $      #
#     $.    #
##########